02 02 
01 01 01 01 01 01 01 01 01 01 01 01 01 01 01 01 01 01 01 01 01 01 01 01 01 01 01 01 01 01 01 01 
01 01 00 01 00 00 00 00 00 00 00 00 00 00 01 01 01 01 01 01 01 00 00 00 00 00 00 00 00 00 00 01 
01 01 01 00 01 00 00 00 00 00 00 00 00 00 00 02 01 01 00 00 00 00 00 00 00 00 00 00 00 00 00 01 
01 01 00 00 00 00 00 00 00 00 00 00 00 00 02 02 01 01 01 01 00 00 00 00 00 00 00 00 00 00 00 01
01 00 01 07 00 00 07 00 00 00 00 00 00 00 02 02 01 01 00 00 00 00 00 01 01 01 01 01 01 01 00 01
01 00 01 00 00 07 00 00 00 00 00 00 00 00 01 01 01 01 01 01 01 00 01 01 00 00 00 00 00 00 00 01
01 01 00 07 00 00 00 00 00 00 00 00 00 00 00 00 00 00 00 00 00 00 00 01 00 00 00 00 00 00 00 01 
01 00 00 00 00 00 00 00 00 00 00 00 00 00 00 00 00 00 00 00 00 00 00 01 00 01 01 01 01 01 01 01 
01 00 00 07 07 07 00 00 00 00 00 00 00 00 00 01 01 00 00 00 00 01 00 01 00 00 00 00 00 00 00 01
01 01 00 00 07 07 00 00 00 00 00 00 00 00 00 00 00 00 00 00 00 00 00 01 00 00 00 00 00 00 00 01 
01 00 00 00 07 07 00 00 00 00 00 00 00 00 00 01 01 00 00 00 00 00 00 01 01 01 01 01 01 01 00 01 
01 01 01 00 07 00 00 00 00 00 00 00 00 00 00 00 00 00 00 00 00 00 01 01 00 00 00 00 00 00 00 01 
01 01 00 00 00 08 00 00 00 00 00 00 00 00 00 00 00 00 00 00 00 00 00 01 00 00 00 00 00 00 00 01
01 00 00 00 00 00 00 00 00 00 00 00 00 00 00 00 00 00 00 00 00 00 00 01 00 01 01 01 01 01 01 01
01 00 00 00 00 00 00 00 00 00 00 00 00 00 08 01 01 08H 00 00 00 00 00 01 00 00 00 00 00 00 00 01 
01 00 00 01 00 01 01 00 00 00 01 00 01 01 01 01 01 01 01 01 01 01 01 01 00 00 00 00 00 00 00 01
01 01 01 00 01 01 01 00 00 01 01 00 01 01 01 01 01 01 01 01 01 01 01 01 01 01 01 01 01 00 00 01 
01 00 00 00 00 00 00 00 00 00 00 00 00 00 00 01 01 00 00 00 00 00 00 00 00 00 00 00 00 00 00 01 
01 00 00 00 00 00 00 00 00 00 00 00 00 00 00 00 00 00 00 00 00 00 00 00 00 00 00 00 00 00 00 01 
01 00 00 00 00 00 00 00 00 00 00 00 08 01 01 01 01 01 01 01 01 00 01 01 01 01 01 01 01 01 01 01
01 00 00 00 01 01 00 01 01 00 01 01 01 01 00 00 00 00 00 01 00 00 00 00 00 00 00 00 00 00 00 01
01 00 00 00 08V 08B 00 08V 08B 00 00 00 00 00 00 00 00 00 00 01 00 00 00 00 00 00 00 00 00 00 00 01
01 00 00 00 00 00 00 00 00 00 00 00 00 00 00 00 00 00 01 01 00 00 00 00 00 00 00 00 00 00 00 01 
01 01 01 00 00 00 00 00 00 00 00 00 00 00 00 00 00 01 01 00 00 00 00 00 00 00 00 00 00 00 00 01 
01 01 01 01 01 00 00 00 00 00 00 00 00 00 00 00 01 01 00 00 00 00 00 00 00 00 00 00 00 00 00 01
00 00 00 01 01 01 01 00 00 00 00 00 00 00 00 00 00 00 00 00 00 00 00 00 00 01 01 01 01 00 00 01 
00 00 00 01 01 01 01 01 01 00 00 00 00 00 00 00 00 00 00 00 00 00 00 00 00 01 01 01 01 00 00 01 
00 00 00 00 00 01 01 01 01 01 01 08H 00 00 00 00 00 00 00 00 00 01 01 00 00 01 01 01 01 00 00 01 
00 00 00 00 00 00 00 08V 01 01 01 01 08H 00 00 00 00 00 00 00 00 01 01 00 00 00 00 00 00 00 00 01
00 00 00 00 00 00 00 00 08V 01 01 01 01 08H 00 00 00 00 00 00 00 00 00 00 00 00 00 00 00 00 00 01
00 00 00 00 00 00 00 00 00 08V 01 01 01 01 08H 00 00 00 00 00 00 00 00 00 00 00 08 01 01 01 01 01 
00 00 00 00 00 00 00 00 00 00 08V 01 01 01 01 01 01 01 01 01 01 01 01 01 01 01 01 01 01 01 01 01

01 01 01 01 01 01 01 01 01 01 01 01 01 01 01 01 01 01 01 01 01 01 01 01 01 01 01 01 01 01 01 01 
01 01 00 01 00 00 00 00 00 00 00 00 00 00 01 01 01 01 01 01 01 00 00 00 00 00 00 00 00 00 00 01 
01 01 01 00 01 00 00 00 00 00 00 00 00 00 00 00 01 01 00 00 00 00 00 00 00 00 00 00 00 00 00 01 
01 01 00 00 00 00 00 00 00 00 00 00 00 00 00 00 01 01 01 01 00 00 00 00 00 00 00 00 00 00 00 01
01 00 01 00 00 00 00 00 00 00 00 00 00 00 00 00 01 01 00 00 00 00 00 01 01 01 01 01 01 01 00 01
01 00 01 00 00 00 00 00 00 00 00 00 00 00 01 01 01 01 01 01 01 00 01 01 00 00 00 00 00 00 00 01
01 01 00 00 00 00 00 00 00 00 00 00 00 00 00 00 00 00 00 00 00 00 00 01 00 00 00 00 00 00 00 01 
01 00 00 00 00 00 00 00 00 00 00 00 00 00 00 00 00 00 00 00 00 00 00 01 00 01 01 01 01 01 01 01 
01 00 00 00 00 00 00 00 00 00 00 00 00 00 00 01 01 00 00 00 00 01 00 01 00 00 00 00 00 00 00 01
01 01 00 00 00 00 00 00 00 00 00 00 00 00 00 00 00 00 00 00 00 00 00 01 00 00 00 00 00 00 00 01 
01 00 00 00 00 00 00 00 00 00 00 00 00 00 00 01 01 00 00 00 00 00 00 01 01 01 01 01 01 01 00 01 
01 01 01 00 00 00 00 00 00 00 00 00 00 00 00 00 00 00 00 00 00 00 01 01 00 00 00 00 00 00 00 01 
01 01 00 00 00 03 00 00 00 00 00 00 00 00 00 00 00 00 00 00 00 00 00 01 00 00 00 00 00 00 00 01
01 00 00 00 00 00 00 00 00 00 00 00 00 00 00 00 00 00 00 00 00 00 00 01 00 01 01 01 01 01 01 01
01 00 00 00 00 00 00 00 00 00 00 00 00 00 03 01 01 02 00 00 00 00 00 01 00 00 00 00 00 00 00 01 
01 00 00 01 00 01 01 00 00 00 01 00 01 01 01 01 01 01 01 01 01 01 01 01 00 00 00 00 00 00 00 01
01 01 01 00 01 01 01 00 00 01 01 00 01 01 01 01 01 01 01 01 01 01 01 01 01 01 01 01 01 00 00 01 
01 00 00 00 00 00 00 00 00 00 00 00 00 00 00 01 01 00 00 00 00 00 00 00 00 00 00 00 00 00 00 01 
01 00 00 00 00 00 00 00 00 00 00 00 00 00 00 00 00 00 00 00 00 00 00 00 00 00 00 00 00 00 00 01 
01 00 00 00 00 00 00 00 00 00 00 00 03 01 01 01 01 01 01 01 01 00 01 01 01 01 01 01 01 01 01 01
01 00 00 00 01 01 00 01 01 00 01 01 01 01 00 00 00 00 00 01 00 00 00 00 00 00 00 00 00 00 00 01
01 00 00 00 05 04 00 05 04 00 00 00 00 00 00 00 00 00 00 01 00 00 00 00 00 00 00 00 00 00 00 01
01 00 00 00 00 00 00 00 00 00 00 00 00 00 00 00 00 00 01 01 00 00 00 00 00 00 00 00 00 00 00 01 
01 01 01 00 00 00 00 00 00 00 00 00 00 00 00 00 00 01 01 00 00 00 00 00 00 00 00 00 00 00 00 01 
01 01 01 01 01 00 00 00 00 00 00 00 00 00 00 00 01 01 00 00 00 00 00 00 00 00 00 00 00 00 00 01
00 00 00 01 01 01 01 00 00 00 00 00 00 00 00 00 00 00 00 00 00 00 00 00 00 01 01 01 01 00 00 01 
00 00 00 01 01 01 01 01 01 00 00 00 00 00 00 00 00 00 00 00 00 00 00 00 00 01 01 01 01 00 00 01 
00 00 00 00 00 01 01 01 01 01 01 02 00 00 00 00 00 00 00 00 00 01 01 00 00 01 01 01 01 00 00 01 
00 00 00 00 00 00 00 05 01 01 01 01 02 00 00 00 00 00 00 00 00 01 01 00 00 00 00 00 00 00 00 01
00 00 00 00 00 00 00 00 05 01 01 01 01 02 00 00 00 00 00 00 00 00 00 00 00 00 00 00 00 00 00 01
00 00 00 00 00 00 00 00 00 05 01 01 01 01 02 00 00 00 00 00 00 00 00 00 00 00 03 01 01 01 01 01 
00 00 00 00 00 00 00 00 00 00 05 01 01 01 01 01 01 01 01 01 01 01 01 01 01 01 01 01 01 01 01 01

1
0001
1
100 100






