01 01
01 01 01 01 01 01 01 01 01 01 01 01 01 01 01 01
01 00 00 00 00 00 00 00 00 00 00 00 00 00 00 01
01 00 00 00 00 00 00 00 00 00 00 00 00 01 00 01
01 00 00 00 00 00 00 00 00 00 00 00 00 00 00 01
01 00 00 00 00 01 00 00 00 00 00 00 00 00 00 01
01 00 00 00 00 01 00 00 00 00 00 00 00 00 00 01
01 00 00 00 00 00 00 00 00 00 00 00 00 00 00 01
01 00 00 00 01 01 01 00 00 00 00 00 00 00 00 01
01 00 00 00 00 00 01 01 01 00 00 00 00 00 00 01
01 00 00 00 00 00 00 00 00 00 00 00 00 01 00 01
01 00 00 00 00 14 13V 13V 13V 13V 13V 13V 13V 01 00 01
01 01 00 00 00 14V 14B 00 00 00 00 00 00 13 00 01
01 12 00 00 00 00 00 00 00 00 00 00 00 00 00 01
01 12 00 00 00 00 00 00 00 00 00 00 01 01 01 01
01 00 13V 13V 01 00 00 00 00 00 00 00 00 13 13 01
01 01 01 01 01 01 01 01 01 01 01 01 01 01 01 01 

01 01 01 01 01 01 01 01 01 01 01 01 01 01 01 01
01 00 00 00 00 00 00 00 00 00 00 00 00 00 00 01
01 00 00 00 00 00 00 00 00 00 00 00 00 01 00 01
01 00 00 00 00 00 00 00 00 00 00 00 00 00 00 01
01 00 00 00 00 01 00 00 00 00 00 00 00 00 00 01
01 00 00 00 00 01 00 00 00 00 00 00 00 00 00 01
01 00 00 00 00 00 00 00 00 00 00 00 00 00 00 01
01 00 00 00 01 01 01 00 00 00 00 00 00 00 00 01
01 00 00 00 00 00 01 01 01 00 00 00 00 00 00 01
01 00 00 00 00 00 00 00 00 00 00 00 00 01 00 01
01 00 00 00 00 13 09 09 09 09 09 09 09 01 00 01
01 01 00 00 00 11 10 00 00 00 00 00 00 08 00 01
01 06 00 00 00 00 00 00 00 00 00 00 00 00 00 01
01 06 00 00 00 00 00 00 00 00 00 00 01 01 01 01
01 00 09 09 01 00 00 00 00 00 00 00 00 08 08 01
01 01 01 01 01 01 01 01 01 01 01 01 01 01 01 01 

1
0001
1
120 100